o0o0o0o0o0o0o0o0o0o0g2g0g0g0g0g4w0w0w0w1
o0o0o0o0o0o0o0o0o0o0g0g0g0g0g0g4w0w0w0w0
o0o0o0o0o0o0o0o0o0o0g0g0g0g0g0g4w0w0w0w0
o0o0o0w0w0w0o0o0o0o0g0g0g0g0g0g4w0w0w0w0
o0o0o0w0w0w0o0o0o0o0g0g0g0g0g0g2g0g0g0g0
o0o0o0o0o0o0o0o0o0o0g0g0g0g0g0g0g0g0g0g0
o1o0o0o4o0o0o0o0o0o2g0g0g0g0g0g0g0g0g0g0
o0o0o4o4o0o0o1f0f0f0g0g0g0g0g0g0g0o0g0g0
o0o4o4o4o0o0o0f0f0f0g0g0g0g0g0g3o0o0o0g0
o4o4o4o4o0o0o0f0f0f0g0g0g0g0g0o0o0o0o0o0
o0o0o0o0o0g0g0g0g0g0f0f0f0o0o0o0o4o4o4o4
g0o0o0o0g3g0g0g0g0g0f0f0f0o0o0o0o4o4o4o0
g0g0o0g0g0g0g0g0g0g0f0f0f0o1o0o0o4o4o0o0
g0g0g0g0g0g0g0g0g0g0o2o0o0o0o0o0o4o0o0o1
g0g0g0g0g0g0g0g0g0g0o0o0o0o0o0o0o0o0o0o0
g0g0g0g0g2g0g0g0g0g0o0o0o0o0w0w0w0o0o0o0
w0w0w0w0g4g0g0g0g0g0o0o0o0o0w0w0w0o0o0o0
w0w0w0w0g4g0g0g0g0g0o0o0o0o0o0o0o0o0o0o0
w0w0w0w0g4g0g0g0g0g0o0o0o0o0o0o0o0o0o0o0
w1w0w0w0g4g0g0g0g0g2o0o0o3o0o0o0o0o0o0o0