g0g4g0g0g0g0g0o0o0o2o0o0o4o0o0o0o0o0o0o1
g0g0g4g0g0o0o0o0o0o0o0o0o4f3f0o0o0o0o0o0
g0g0o0o4o0o0o0o0o0o0o0o0o4f0f0o0o0o0o0o0
o3o0o0o0o4o0o0o0g4f0f0g4o4o0o0o4o4o4o4o4
o0o0o4o0o0o4o1o0g4f0f0g4o4o0o0o3o0o0o0o0
o0o0o4o0o0o0o4o0g0f0f0g0o0o0o0o0o0o0o0o0
o0w0w4w0o0o0o0o0g0f0f0g0o0o0o0o0w0w0w1o0
o0w0w0w2o0o0o0o0g0f0f1g0o0o0o0o0w0w0w0o0
o0w0w0w4g4g4g0g4f0f0f0f0g4g0g4g4w4w0w0o0
o4w0w0w0f0f0f0f0f0f0f0f0f2f0f0f0w0w0w0o4
o4w0w0w0f0f0f0f2f0f0f0f0f0f0f0f0w0w0w0o4
o0w0w0w4g4g4g0g4f0f0f0f0g4g0g4g4w4w0w0o0
o0w0w0w0o0o0o0o0g0f1f0g0o0o0o0o0w0w0w0o0
o0w1w0w0o0o0o0o0g0f0f0g0o0o0o0o0w2w4w0o0
o0o0o0o0o0o0o0o0g0f0f0g0o0o4o0o0o0o4o0o0
o0o0o0o3o0o0o0o4g4f0f0g4o0o1o4o0o0o4o0o0
o4o4o4o4o4o0o0o4g4f0f0g4o0o0o0o4o0o0o0o3
o0o0o0o0o0f0f0o4o0o0o0o0o0o0o0o0o4o0g0g0
o0o0o0o0o0f0f3o4o0o0o0o0o0o0o0g0g0g4g0g0
o1o0o0o0o0o0o0o4o0o0o2o0o0g0g0g0g0g0g4g0