g0g0g0g0g0g0g0g0g0g0g0g0g0g0g0g0g4g4g4g4
g0g0g0g0g0w4w4w0w0w0w0w0w0w4w4g0g0g0g2g4
g0g0g0g0g0w0w0w0w0w3w0w0w0w0w0g0g0g0g0g4
g1g0g0g0g0w4w4w0w0w0w0w0w0w4w4g0g0g0g0g4
g0g0g0g0g2g0g0g0g0g0g0g0g0g0g0g1g0g0g0g0
g4g4g4g4g4g0g4g0g4g4g0g0g0g0g4g4g0g0g0g0
g0w0w0w1g4g0g0g0g4g0g0g0g0g4g0g4w2w0w0g0
g0w0w4w0g4g0g0g0g0g0g0g1g0g0g0g4w0w4w0g0
g0w0w4w0g4g0g4g0g0o0o4g0g0g0g0g4w0w4w0g0
g3w0w4w0g4g0g0g0g0o0o0g4g4g4g3g4w0w4w0g0
g0w0w4w0g4g3g4g4g4o0o0g0g0g0g0g4w0w4w0g3
g0w0w4w0g4g0g0g0g0o4o0g0g0g4g0g4w0w4w0g0
g0w0w4w0g4g0g0g0g1g0g0g0g0g0g0g4w0w4w0g0
g0w0w0w2g4g0g4g0g0g0g0g4g0g0g0g4w1w0w0g0
g0g0g0g0g4g4g0g0g0g0g4g4g0g4g0g4g4g4g4g4
g0g0g0g0g1g0g0g0g0g0g0g0g0g0g0g2g0g0g0g0
g4g0g0g0g0w4w4w0w0w0w0w0w0w4w4g0g0g0g0g1
g4g0g0g0g0w0w0w0w0w0w3w0w0w0w0g0g0g0g0g0
g4g2g0g0g0w4w4w0w0w0w0w0w0w4w4g0g0g0g0g0
g4g4g4g4g0g0g0g0g0g0g0g0g0g0g0g0g0g0g0g0