g0g0g0g1g0g0g0g0g0g3g0g0g0g0g0o2o0o4o4o4
g0g0g0g0g0g0g0g0g0g0g0g0g0g0g0o0o0o4o0o0
g0g0g0g0g0g0g0g0g0g0g0g0g0g0g0o0o0o4o0o1
g4g4g4g0g0g0g0g0g0g0g0g0g0g0g0o0o0o4o0o0
o0o0o0o0o0o0o0o0o0o0o0o0o0o0o0o4o4o4o0o2
o0o0o0o0o3o0o0o0o0o0o0o0o0o0o0o0o0o0o0o0
o0o0o0o0o0o0o0o0o0o0o0o0o0o0o0o0f0f0f0f0
o0o0o0o0o0o0o0o0o0w0w0o0o0o0o0o1f0f0f0f0
f0f0f0f0o4o4o4o4w0w0w0w0o4o4o4o4f0f0f0f0
f0f0f0f0o4w0w0w0w0w0w0w0w0w0w0o4f0f0f3f0
f0f3f0f0o4w0w0w0w0w0w0w0w0w0w0o4f0f0f0f0
f0f0f0f0o4o4o4o4w0w0w0w0o4o4o4o4f0f0f0f0
f0f0f0f0o1o0o0o0o0w0w0o0o0o0o0o0o0o0o0o0
f0f0f0f0o0o0o0o0o0o0o0o0o0o0o0o0o0o0o0o0
o0o0o0o0o0o0o0o0o0o0o0o0o0o0o0o3o0o0o0o0
o2o0o4o4o4o0o0o0o0o0o0o0o0o0o0o0o0o0o0o0
o0o0o4o0o0g0g0g0g0g0g0g0g0g0g0g0g0g4g4g4
o1o0o4o0o0g0g0g0g0g0g0g0g0g0g0g0g0g0g0g0
o0o0o4o0o0g0g0g0g0g0g0g0g0g0g0g0g0g0g0g0
o4o4o4o0o2g0g0g0g0g0g3g0g0g0g0g0g1g0g0g0