w0w0w4w4w0w0w0w1w0w0w0w4w0w2w0g4g0g0g0g3
w0w0w0w0w0w0w0w0w0w0w0w4w0w0w0g4g0g0g0g0
w3w0w0w0w0w0w0w0w0w0w0w4w0w0w0w0w0w0g0g0
w0w0w0w0w0w0w0w0w0w0w3w4w4w4w4w4w4w0g0g0
w0w0w0w0w0w0w0w0w0w0w0w0w0w0w0w0w0w0g4g4
w2w0w0w0w3o0o0o0o0o0o0o0o0o0o0w3w0w0w0w0
w0w0w0w0w4o4o0o0o0o0o0o0o0o0o4w4w0w0w0w0
w0w0w0w0w4o0o0f0f0f0f0f0f4o0o0w4w0w0w0w1
w0w0w0w0w4o0o0f1f0f0f0f0f2o0o0w4w0w0w0w0
w0w0w0w0w4o4o0f4f4f0f0f0f4o0o4w4w0w0w0w0
w0w0w0w0w4o4o0f4f0f0f0f4f4o0o4w4w0w0w0w0
w0w0w0w0w4o0o0f2f0f0f0f0f1o0o0w4w0w0w0w0
w1w0w0w0w4o0o0f4f0f0f0f0f0o0o0w4w0w0w0w0
w0w0w0w0w4o4o0o0o0o0o0o0o0o0o4w4w0w0w0w0
w0w0w0w0w3o0o0o0o0o0o0o0o0o0o0w3w0w0w0w2
g4g4w0w0w0w0w0w0w0w0w0w0w0w0w0w0w0w0w0w0
g0g0w0w4w4w4w4w4w4w3w0w0w0w0w0w0w0w0w0w0
g0g0w0w0w0w0w0w0w4w0w0w0w0w0w0w0w0w0w0w3
g0g0g0g0g4w0w0w0w4w0w0w0w0w0w0w0w0w0w0w0
g3g0g0g0g4w0w2w0w4w0w0w0w1w0w0w0w4w4w0w0