o0o0o0o0o0o0o0o3o0o0w0w0w0w0w0w0f0f0f0f1
o0o0o0o0o0o0o0o0o0o0w0w0w0w0w0w0f0f0f0f0
o3o0o0o0o0o0o0o0o0o0w0w0w3w0w0w4f0f0f0f0
o0o0o0f0f0f0o0o0o0o0w0w0w0w0w0w4f0f0f0f0
o0o0o0f0f0f0o0o0o0o0w0w0w0w0w0w2w0w0w0w0
o0o0o0o0o0o0o0o0o0o0w0w0w2w0w0w0w0w0w0w0
o1o0o0o4o0o0o0o0o0o2w0w0w0w0w0w0w0w0w0w0
o0o0o0o4o0o0o0o0o0o0w0w0w4w4w4w0w0o0w0w0
o0o4o0o4o0o0o0o0o0o0w0w0w0w4w1w0o0o0o0w0
o4o4o0o4o0o0o0o0o0o0w0w0w0w4w0o0o0o0o0o0
o0o0o0o0o0w0w4w0w0w0o0o0o0o0o0o0o4o0o4o4
w0o0o0o0w0w1w4w0w0w0o0o0o0o0o0o0o4o0o4o0
w0w0o0w0w0w4w4w4w0w0o0o0o0o0o0o0o4o0o0o0
w0w0w0w0w0w0w0w0w0w0o2o0o0o0o0o0o4o0o0o1
w0w0w0w0w0w0w0w2w0w0o0o0o0o0o0o0o0o0o0o0
w0w0w0w0w2w0w0w0w0w0o0o0o0o0f0f0f0o0o0o0
f0f0f0f0w4w0w0w0w0w0o0o0o0o0f0f0f0o0o0o0
f0f0f0f0w4w0w0w3w0w0o0o0o0o0o0o0o0o0o0o3
f0f0f0f0w0w0w0w0w0w0o0o0o0o0o0o0o0o0o0o0
f1f0f0f0w0w0w0w0w0w0o0o0o3o0o0o0o0o0o0o0